# Simple replace table for soft suggestions
# Format: word=suggestion1|suggestion2|suggestion3...

автовишка=автовежа
автогонщик=автогонник
автозасмага=самозасмага
акаунт=обліковий запис|рахунок
апдейт=оновлення
ашгабадський=ашгабатський
Ашхабад=Ашгабат
бетононасос=бетонопомпа
біл-борд=білборд
біложаровий=білорозжарений
Білорусія=Білорусь
блок-бастер=блокбастер
блок-пост=блокпост
блок-флейта=блок-флейта
борщовик=борщівник
братолюбивість=братолюбність
брелок=дармовис
везунчик=щасливець|щасливчик
велогонщик=велогонник
велогонщиця=велогонниця
венгерський=угорський
вендор=постачальник
вердієвський=вердівський
вердіївський=вердівський
взаємодоповнюваний=взаємодоповняльний
видумка=вигадка
вижга=випал
виплавлення=витоплення
виплавлювання=витоплювання
виплавлювати=витоплювати
вишка=вежа|вартівня|шпилик
відмоніторити=промоніторити
відображати=ctx: математика|показувати|зображати|відбивати
відображатися=ctx: математика|показуватися|зображатися|відбиватися
відображений=ctx: математика|відбитий|зображений|показаний
відображення=ctx: математика|відбивання|відбиття|відбиток|зображення|показ
відображуваний=ctx: математика|відбиваний|зображуваний|показуваний
відобразити=ctx: математика|показати|зобразити|відбити
відобразитися=ctx: математика|показатися|зобразитися|відбитися
відпарируваний=відбитий
відсканований=засканований|просканований
відсканувати=засканувати|просканувати
відскануватися=заскануватися|проскануватися
відцензурований=процензурований
відцензурувати=процензурувати
відцифрований=зацифрований
відцифрувати=зацифрувати
відшуковувати=відшукувати
водогазоємний=водогазомісткий
водоємність=водомісткість
вологоємний=вологомісткий
вологоємність=вологомісткість
волонтерувати=волонтерити
вольність=вільність|привілей
ворчестерський=вустерський
вторгатися=вдиратися|впиратися
вторгнутися=вдертися|впертися
Ганді=Ґанді
Гаяна=Гайана (Класифікатор країн світу)
Гейзенберг=Гайзенберг
Гейзенберґ=Гайзенберґ
Гете=Ґете
Гете-інститут=Ґете-інститут
ГКЧП=ДКНС
ґміна=гміна
Голосієве=Голосіїв
Голосієво=Голосіїв
гонщик=перегінник
гонщиця=перегінниця
Греммі=Ґреммі
Ґренландія=Гренландія (Класифікатор країн світу)
грошолюбивий=грошолюбний
Д'Артаньян=д'Артаньян
давньоіудейський=давньоюдейський
даїшник=даївець|даєць
датський=данський
датсько-ісландський=дансько-ісландський
датсько-шведський=дансько-шведський
датчанин=данець
датчанка=данка
двохмільйонний=двомільйонний
двохмільярдний=двомільярдний
двохтисячний=двотисячний
дедлайн=граничний термін (реченець)|кінцева дата
дед-лайн=граничний термін (реченець)|кінцева дата
Демокрит=Демокріт
держатель=власник|тримач|держальник
дієспроможний=дієздатний
дієспроможність=дієздатність
дніпропетровець=дніпровець|дніпрянин
дніпропетровка=дніпровка|дніпрянка
дніпропетровчанка=дніпрянка
дружище=друзяка
думпер=малоскид
духовенство=духівництво
Ейнштейн=Айнштайн
екаунт=обліковий запис|рахунок
електроємний=електромісткий
електроємнісний=електромісткісний
енергоємний=енергомісткий
енергоємність=енергомісткість
Ерзерум=Ерзурум
ємний=місткий
ємнісний=місткісний
ємність=місткість
ємно=містко
желатерія=джелатерія
жертвенний=жертовний
загородній=позаміський|приміський
загрожуваний=загрожений
задовільнити=задовольнити
задовільнитися=задовольнитися
задушевний=сердечний|щирий|щиросердечний|душевний
задушевність=сердечність|щирість|щиросердечність|душевність
заклеймити=затаврувати
заклеймлений=затаврований
заклеймований=затаврований
заклеймувати=затаврувати
закупівельник=закупник
зарплатовий=зарплатний
збаражець=збаражанин
збаражчанин=збаражанин
землевідвід=землевідведення
Ідейє=Ідеє
інь=їнь
іуда=юда
Іуда=Юда
іудаїзм=юдаїзм
іудей=юдей
іудейка=юдейка
іудейство=юдейство
іудейський=юдейський
іудео-арабський=юдео-арабський
іудео-перський=юдео-перський
іудин=юдин
Іудин=Юдин
казначей=скарбник
казначейство=скарбниця
казначейський=скарбничий
канадійський=канадський
капіталоємний=капіталомісткий
капіталоємність=капіталомісткість
каремат=каримат
катехізація=катехизація
катехізис=катехизис
катехізисний=катехизисний
катехізичний=катехизисний
квазівчений=квазінауковець
Китаєво=Китаїв
кіношник=кінороб
ковшик=ківшик
колчан=сагайдак
коментарій=коментар
кременчужанин=кременчуківець
Кушка=Серхетабат|Серхетабад
лайфхак=корисняк
лінитися=лінуватися
лонглист=довгий список
лонг-лист=довгий список
лонгліст=довгий список
лонг-ліст=довгий список
лонгрід=довгочит
лузер=невдаха
мазохістичний=мазохістський
майєвтика=маєвтика
марочний=марковий
маслонасос=оливова помпа
маститий=сивоголовий|поважний|почесний|шановний
матеріалоємний=матеріаломісткий
матеріалоємність=матеріаломісткість
мейнстрімівський=мейнстрімовий
металобрухтовий=брухтовий
металоємний=металомісткий
металоємність=металомісткість
Мілошевіч=Милошевич
мініінвазивний=малоінвазивний
міні-інвазивний=малоінвазивний
мініінвазійний=малоінвазивний
міні-інвазійний=малоінвазивний
Мінусінськ=Мінусинськ
місцерозташування=місце розташування
мітчик=значильник|значій
мітчик=різьборіз|гайкоріз|мутроріз
многогрішний=ctx: релігія,поезія|великогрішний|великогрішник
многостраждальний=ctx: релігія,поезія|великостраждальний|великострадний
многотрудний=ctx: релігія,поезія|великотрудний|велетрудний|(дуже) трудний|(дуже) важкий
мотогонщик=мотогонник
Мочалине=Молчалине
мурал=стінопис
наглядний=ctx: як наглядовий|наочний
налаштунок=налаштовання
наперстник=наперсник
напіврозплавлений=напіврозтоплений
наробок=доробок|напрацювання
нарцистичний=нарцисичний
нашвидкоруч=на швидку руку|нашвидкуруч|нашвидку|швидкома|прихапцем|похапцем
нелюбимий=нелюбий
неофіціальний=неофіційний
неофіціальність=неофіційність
непідвідомчий=непідпорядкований|непідрядний
непідвідомчість=непідпорядкованість|непідрядність
нобеліант=нобеліат
нобеліантка=нобеліатка
нобеліст=нобеліат
нобелістка=нобеліатка
нобелянт=нобеліат
нобелянтка=нобеліатка
носоглотка=носогорло|носопролиг
нью-орлеанський=новоорлеанський
обвинувачувач=обвинувач
обнародуваний=оприлюднений|оголошений
обнародування=оприлюднення|оголошення
обнародувати=оприлюднити|оголосити
обнародуватися=оприлюднювати|оголошувати
обнулитися=занулитися|встановитися на нуль
обстановка=обстава|обставини
односельчанин=односелець
односельчанка=односелиця
Озірщина=Озерщина
омочений=обмочений
осевий=осьовий
офіціальний=офіційний
офіціальність=офіційність
оцифрований=зацифрований
оцифровування=зацифровування
оцифровуватися=зацифровувати
оцифрування=зацифрування
оцифрувати=зацифрувати
оцифруватися=зацифруватися
павперизація=пауперизація
паелья=паейя
параолімпієць=паралімпієць
параолімпійський=паралімпійський
парируваний=відбиваний|відбитий
паровоз=паротяг
паровозобудівельний=паротягобудівний
паровозобудівний=паротягобудівний
паровозобудівник=паротягобудівник
паровозоремонтний=паротягоремонтний
пеленання=сповивання
перетермінований=протермінований
Петики=Петихи
Пирогово=Пирогів
підвідомчий=підпорядкований|підрядний
підвідомчість=підпорядкованість|підрядність
підгороддя=передмістя
планірка=планівка|коротка нарада
подалі=трохи далі|якомога далі
поздоровчий=вітальний|віншувальний|поздоровний
полісімейкер=творець політики|нормотворчий орган|орган (особа), що визначає політику
полтавчанин=полтавець
полтавчанка=полтавка
поствоєнний=післявоєнний|повоєнний
постноворічний=післяноворічний
постправда=післяправда
постправдний=післяправдний
постсвятковий=післясвятковий
поул-позишн=поул-позиція
поцілювати=поціляти
поціновка=оцінка|оцінювання
призупинений=(тимчасово) зупинений
призупинення=(тимчасове) зупинення
призупинити=(тимчасово) зупинити|перепинити|притишити|пригальмувати
призупинитися=(тимчасово) зупинитися|притишитися|пригальмуватися
призупиняти=(тимчасово) зупиняти|перепиняти|пригальмовувати
призупинятися=(тимчасово) зупинятися|перепинятися|пригальмовуватися
пріквел=приквел
просвітитель=просвітник
просвітительство=просвітництво
просвітительський=просвітницький
професіональніший=професійніший
профпідготування=профвишкіл
псевдовчений=псевдонауковець
пустодзвонний=пустодзвінний
пустодзвонність=пустодзвінність
РАГС=РАЦС
радіовишка=радіовежа
радіокоментарій=радіокоментар
рейхсканцлер=райхсканцлер
рейхскомісаріат=райхскомісаріат
рейхсфюрер=райхсфюрер
ресурсоємний=ресурсомісткий
ресурсоємність=ресурсомісткість
рециклінг=рециклювання
розділка=риска
роздрук=видрук
роздрукований=видрукований
роздруковуваний=видруковуваний
роздруковування=видруковування
роздруковувати=видруковувати
роздруковуватися=видруковуватися
роздрукування=видрукування
роздрукувати=видрукувати
роздрукуватися=видрукуватися
розукрупнений=подрібнений|розбитий
ротаріанець=ротарієць
русло=річище
русловий=річищний
Савойя=Савоя
самолюбивий=самолюбний
Святошино=Святошин
сінефіл=синефіл
сінефільський=синефільський
скролінг=гортання|прокручування
слизистий=слизуватий
смільчак=сміливець
соціо-культурний=соціокультурний
спасатися=ctx: релігія,поезія|рятуватися|визволятися
спасіння=ctx: релігія,поезія|рятування|рятунок|порятунок|визволення
співробітничати=співпрацювати
стекла=скла
стеклам=склам
стеклами=склами
стеклах=склах
стекол=скел
стоднівка=стоденка
сумчанин=сум'янин
сумчанка=сум'янка
суперпровідність=надпровідність
твердосплавний=твердостоповий
твердосплавність=твердостоповість
телебашта=телевежа
теплоємний=тепломісткий
теплоємність=тепломісткість
териякі=теріякі
тернопільчанин=тернополянин
тернопільчанка=тернополянка
товкотнеча=тиснява|товчія|штовханина
Толкієн=Толкін
толкієнівський=толкінівський
толкієнізмом=толкінізм
трефа=жир
трускавка=полуниця
трьохмільйонний=тримільйонний
трьохмільярдний=тримільярдний
трьохтисячний=тритисячний
Уотсон=Вотсон
услуга=послуга
Успіння=Перша пречиста
Фердінанд=Фердинанд
Фердінандів=Фердинандів
фондоємний=фондомісткий
фондоємність=фондомісткість
фрейдизм=фройдизм
фрейдист=фройдист
фрейдівський=фройдівський
хльосткий=хвиський|дошкульний|шпаркий
хльосткіший=хвиськіший|дошкульніший|шпаркіший
хобіт=гобіт
хостеса=хостес
циркадний=добовий
часникодавка=часникочавка
чеддер=чедер
червак=черв'як
чернігівчанин=чернігівець
чернігівчанка=чернігівка
чотирьохмільйонний=чотиримільйонний
чотирьохмільярдний=чотиримільярдний
чотирьохтисячний=чотиритисячний
шарикопідшипник=кулькова вальниця|кульковальниця
шарикопідшипниковий=кульковальничний
шведомовний=шведськомовний /adj
шкло=скло
шльопанець=ляпанець
шортлист=короткий список
шорт-лист=короткий список
шортліст=короткий список
шорт-ліст=короткий список
Штайнмайєр=Штайнмаєр
щімкий=щемкий
янь=ян
