# The opposite of added.txt: these readings will be removed.
# Useful to remove incorrect readings from the binary dictionary without rebuilding it.
# File Encoding: UTF-8
# Format: fullform baseform postags (tab separated)
adhesion	adhesion	NN:U
alert	alert	VBG
annulling	annulling	NNS
appalling	appalling	NNS
assailing	assailing	NNS
atomic	atomic	NN
baffling	baffling	NNS
battling	battling	NNS
blows	blows	NN
bottling	bottling	NNS
bowling	bowling	NNS
brief	brief	VBG
buckling	buckling	NNS
bugs	bugs	JJ
bundling	bundling	NNS
cabling	cabling	NNS
cancelling	cancelling	NNS
cars	cars	NN
channelling	channelling	NNS
chronicling	chronicling	NNS
comingling	comingling	NNS
compelling	compelling	NNS
controlling	controlling	NNS
counselling	counselling	NNS
course	course	JJ
courser	course	JJR
cowling	cowling	NNS
crawling	crawling	NNS
culling	culling	NNS
curling	curling	NNS
dangling	dangling	NNS
defuelling	defuelling	NNS
earlier	earlier	JJ
earliest	earliest	JJ
enfranchize	enfranchize	VB
enfranchize	enfranchize	VBP
equalling	equalling	NNS
excelling	excelling	NNS
fathers	father	VBZ
ferrying	ferrying	NNS
filling	filling	NNS
fold	fold	JJ
folder	fold	JJR
forestalling	forestalling	NNS
fouling	fouling	NNS
fuelling	fuelling	NNS
fulfilling	fulfilling	NNS
galling	galling	NNS
garbling	garbling	NNS
handling	handling	NNS
hypothesises	hypothesis	NNS
idling	idling	NNS
ie	ie	JJ
impelling	impelling	NNS
inkling	inkling	NNS
installing	installing	NNS
jewelling	jewelling	NNS
journeying	journeying	NNS
kneeling	kneeling	NNS
labelling	labelling	NNS
leveling	leveling	NNS
login	login	VB
login	login	VBP
lower	lowe	JJR
marshalling	marshalling	NNS
marvelling	marvelling	NNS
maximiser	maximizer	NNS
maximisers	maximizer	NNS
metabolisable	metabolizable	JJ
milling	milling	NNS
mineralisation	mineralization	NNS
mingling	mingling	NNS
mislabelling	mislabelling	NNS
oiling	oiling	NNS
opsonised	opsonize	VBD
opsonised	opsonize	VBN
owner	own	JJR
parenthesises	parenthesis	NNS
pooling	pooling	NNS
pressurisation	pressurization	NNS
prickly	prickly	RB
propelling	propelling	NNS
pulling	pulling	NNS
pur	pur	JJ
quarrelling	quarrelling	NNS
railing	railing	NNS
rappelling	rappelling	NNS
rebelling	rebelling	NNS
recrystallisation	recrystallization	NNS
refuelling	refuelling	NNS
relabelling	relabelling	NNS
reverser	reverse	JJR
robotic	robotic	NN
sailing	sailing	NNS
sampling	sampling	NNS
seal	seal	NNS
sealing	sealing	NNS
selling	selling	NNS
settling	settling	NNS
shackling	shackling	NNS
shapely	shapely	RB
should	should	JJ
shrivelling	shrivelling	NNS
signalling	signalling	NNS
so	so	NN:U
spams	Spam	NNPS
sparkling	sparkling	NNS
species	specie	NNS
spicer	spic	JJR
stencilling	stencilling	NNS
styling	styling	NNS
supersize	supersize	NN
tackling	tackling	NNS
televize	televize	VB
televize	televize	VBP
telling	telling	NNS
tenfold	tenfold	NN
three-fold	three-fold	NN
tooling	tooling	NNS
traveling	traveling	NNS
travelling	travelling	NNS
trickling	trickling	NNS
twofold	twofold	NN
two-fold	two-fold	NN
underling	underling	NNS
unravelling	unravelling	NNS
unsightly	unsightly	RB
utilisable	utilizable	JJ
word	word	NN:UN
wrought	work	VBD
wrought	work	VBN
xx	xx	JJ
xxx	xxx	JJ
