# entries to be removed from the postag database
Duitsland	Duitsland	ZNW:EKV:HET
anemieker	anemiek	BNW:VGR:ONV
anemiekere	anemiek	BNW:VGR:VRB
anemiekers	anemiek	BNW:VGR:IET
anemieks	anemiek	BNW:STL:IET
anemiekst	anemiek	BNW:OVR:ONV
anemiekste	anemiek	BNW:OVR:VRB
babyvrije	babyvrije	BNW:STL:VRB
capo	capo	ZNW:EKV
klankboord	klankboord	ZNW:EKV
klankboorden	klankboord	ZNW:MRV:DE_
klankboordgroep	klankboordgroep	ZNW:EKV:DE_
klankboordgroepen	klankboordgroep	ZNW:MRV:DE_
klankboordgroepje	klankboordgroep	ZNW:EKV:VRK:HET
klankboordgroepjes	klankboordgroep	ZNW:MRV:VRK:DE_
klankboordje	klankboord	ZNW:EKV:VRK:HET
klankboordjes	klankboord	ZNW:MRV:VRK:DE_
verkeersboord	verkeersboord	ZNW:EKV
verkeersboorden	verkeersboord	ZNW:MRV:DE_
verkeersboordje	verkeersboord	ZNW:EKV:VRK:HET
verkeersboordjes	verkeersboord	ZNW:MRV:VRK:DE_
vorstellende	vorstellende	ZNW:EKV:DE_
vorstellenden	vorstellende	ZNW:MRV:DE_
vorstellendes	vorstellende	ZNW:MRV:DE_
passpoort	passpoort	ZNW:EKV
passpoorten	passpoort	ZNW:MRV:DE_
passpoortje	passpoort	ZNW:EKV:VRK:HET
passpoortjes	passpoort	ZNW:MRV:VRK:DE_
passwoord	passwoord	ZNW:EKV
passwoorden	passwoord	ZNW:MRV:DE_
passwoordje	passwoord	ZNW:EKV:VRK:HET
passwoordjes	passwoord	ZNW:MRV:VRK:DE_
uithangboord	uithangboord	ZNW:EKV
uithangboorden	uithangboord	ZNW:MRV:DE_
uithangboordje	uithangboord	ZNW:EKV:VRK:HET
uithangboordjes	uithangboord	ZNW:MRV:VRK:DE_
hoofdboord	hoofdboord	ZNW:EKV
hoofdboorden	hoofdboord	ZNW:MRV:DE_
hoofdboordje	hoofdboord	ZNW:EKV:VRK:HET
hoofdboordjes	hoofdboord	ZNW:MRV:VRK:DE_
poortvrijs	poortvrij	BNW:STL:IET
spatboord	spatboord	ZNW:EKV
boorduurwerk	boorduurwerk	ZNW:EKV:HET
boorduurwerken	boorduurwerk	ZNW:MRV:DE_
boorduurwerkje	boorduurwerk	ZNW:EKV:VRK:HET
boorduurwerkjes	boorduurwerk	ZNW:MRV:VRK:DE_
passport	passport	ZNW:EKV
passporten	passport	ZNW:MRV:DE_
groepslijder	groepslijder	ZNW:EKV:DE_
kortoren	kortoren	ZNW:EKV
kortorens	kortoren	ZNW:MRV:DE_
kortorentje	kortoren	ZNW:EKV:VRK:HET
kortorentjes	kortoren	ZNW:MRV:VRK:DE_
lazers	lazer	ZNW:MRV:DE_
toetsenboord	toetsenboord	ZNW:EKV
transpoort	transpoort	ZNW:EKV:DE_
transpoorten	transpoorten	ZNW:MRV:DE_
transpoortmiddelen	transpoortmiddelen	ZNW:MRV:DE_
transpoortmogelijkheden	transpoortmogelijkheden	ZNW:MRV:DE_
transpoortstromen	transpoortstromen	ZNW:MRV:DE_
transpoortvloot	transpoortvloot	ZNW:EKV:DE_
trendzetter	trendzetter	ZNW:EKV:DE_
trendzetters	trendzetter	ZNW:MRV:DE_
trendzettertje	trendzetter	ZNW:EKV:VRK:HET
trendzettertjes	trendzetter	ZNW:MRV:VRK:DE_
trendzetting	trendzetting	ZNW:EKV:DE_
trendzettingen	trendzetting	ZNW:MRV:DE_
zenuwleider	zenuwleider	ZNW:EKV:DE_
zenuwleiders	zenuwleider	ZNW:MRV:DE_
lazer-	lazer-	DVS
lazer-schiettent	lazer-schiettent	ZNW:EKV:DE_
lazer-therapie	lazer-therapie	ZNW:EKV:DE_
lazerbehandeling	lazerbehandeling	ZNW:EKV:DE_
lazerbehandelingen	lazerbehandeling	ZNW:MRV:DE_
lazerbesturing	lazerbesturing	ZNW:EKV:DE_
lazerblad	lazerblad	ZNW:EKV:HET
lazerbrandapparaat	lazerbrandapparaat	ZNW:EKV:HET
lazergeleide	lazergeleide	BNW:STL:VRB
lazerimpulsen	lazerimpulsen	ZNW:MRV:DE_
lazerkachel	lazerkachel	ZNW:EKV:DE_
lazerkrans	lazerkrans	ZNW:EKV:DE_
lazerlamp	lazerlamp	ZNW:EKV:DE_
lazerlampje	lazerlamp	ZNW:EKV:VRK:HET
lazerlichteffecten	lazerlichteffecten	ZNW:MRV:DE_
lazerlichtje	lazerlichtje	ZNW:EKV:VRK:HET
lazerlijn	lazerlijn	ZNW:EKV:DE_
lazerlijnen	lazerlijnen	ZNW:MRV:DE_
lazeronderzoek	lazeronderzoek	ZNW:EKV:HET
lazerpennen	lazerpennen	ZNW:MRV:DE_
lazerpistool	lazerpistool	ZNW:EKV:HET
lazerprinter	lazerprinter	ZNW:EKV:DE_
lazerprinters	lazerprinter	ZNW:MRV:DE_
lazerscanners	lazerscanners	ZNW:MRV:DE_
lazersensor	lazersensor	ZNW:EKV:DE_
lazershow	lazershow	ZNW:EKV:DE_
lazershows	lazershow	ZNW:MRV:DE_
lazersignaal	lazersignaal	ZNW:EKV:HET
lazersleutelhangers	lazersleutelhangers	ZNW:MRV:DE_
lazersnijders	lazersnijders	ZNW:MRV:DE_
lazerspelertje	lazerspelertje	ZNW:EKV:VRK:HET
lazerstraal	lazerstraal	ZNW:EKV:DE_
lazerstraalt	lazerstraalt	ZNW:EKV:DE_
lazerstraaltje	lazerstraal	ZNW:EKV:VRK:HET
lazerstraaltjes	lazerstraal	ZNW:MRV:VRK:DE_
lazerstralen	lazerstralen	ZNW:MRV:DE_
lazerstukken	lazerstukken	ZNW:MRV:DE_
lazertechniek	lazertechniek	ZNW:EKV:DE_
lazertechnieken	lazertechniek	ZNW:MRV:DE_
lazertechnologie	lazertechnologie	ZNW:EKV
lazertherapie	lazertherapie	ZNW:EKV:DE_
lazertoestel	lazertoestel	ZNW:EKV:HET
lazerverbinding	lazerverbinding	ZNW:EKV:DE_
lazerzwaard	lazerzwaard	ZNW:EKV:HET
lazerzwaarden	lazerzwaard	ZNW:MRV:DE_
zondevoeding	zondevoeding	ZNW:EKV
zondevoedingen	zondevoeding	ZNW:MRV:DE_
zondevoedingetje	zondevoeding	ZNW:EKV:VRK:HET
zondevoedingetjes	zondevoeding	ZNW:MRV:VRK:DE_
zondevoedinkje	zondevoeding	ZNW:EKV:VRK:HET
zondevoedinkjes	zondevoeding	ZNW:MRV:VRK:DE_
vitting	vitting	ZNW:EKV
vittingen	vitting	ZNW:MRV:DE_
vittingetje	vitting	ZNW:EKV:VRK:HET
vittinkje	vitting	ZNW:EKV:VRK:HET
vittinkjes	vitting	ZNW:MRV:VRK:DE_
formen	form	ZNW:MRV:DE_
formpje	form	ZNW:EKV:VRK:HET
formpjes	form	ZNW:MRV:VRK:DE_
hoogtefrees	hoogtefrees	ZNW:EKV:DE_
hoogtefreesje	hoogtefrees	ZNW:EKV:VRK:HET
hoogtefreesjes	hoogtefrees	ZNW:MRV:VRK:DE_
hoogtefrezen	hoogtefrees	ZNW:MRV:DE_
publicatieboord	publicatieboord	ZNW:EKV
publicatieboorden	publicatieboord	ZNW:MRV:DE_
publicatieboordje	publicatieboord	ZNW:EKV:VRK:HET
publicatieboordjes	publicatieboord	ZNW:MRV:VRK:DE_
sleutelboord	sleutelboord	ZNW:EKV
sleutelboorden	sleutelboord	ZNW:MRV:DE_
sleutelboordje	sleutelboord	ZNW:EKV:VRK:HET
sleutelboordjes	sleutelboord	ZNW:MRV:VRK:DE_
verlijder	verlijder	ZNW:EKV
verlijders	verlijder	ZNW:MRV:DE_
verlijdertje	verlijder	ZNW:EKV:VRK:HET
verlijdertjes	verlijder	ZNW:MRV:VRK:DE_
vertrekboord	vertrekboord	ZNW:EKV
vertrekboorden	vertrekboord	ZNW:MRV:DE_
vertrekboordje	vertrekboord	ZNW:EKV:VRK:HET
vertrekboordjes	vertrekboord	ZNW:MRV:VRK:DE_
hoor	hoor	ZNW:EKV
hoortje	hoor	ZNW:EKV:VRK:HET
hoortjes	hoor	ZNW:MRV:VRK:DE_
horen	hoor	ZNW:MRV:DE_
uitgelegen	uitliggen	WKW:VTD:ONV
uitlag	uitliggen	WKW:VLT:1EP
uitlagen	uitliggen	WKW:VLT:INF
uitlig	uitliggen	WKW:TGW:1EP
uitligge	uitliggen	WKW:AWS
uitliggen	uitliggen	WKW:TGW:INF
uitliggend	uitliggen	WKW:ODW:ONV
uitliggende	uitliggen	WKW:ODW:VRB
uitliggenden	uitliggen	WKW:ODW:MRV:DE_
uitligt	uitliggen	WKW:TGW:3EP
buitenboord	buitenboord	ZNW:EKV
buitenboorden	buitenboord	ZNW:MRV:DE_
buitenboordje	buitenboord	ZNW:EKV:VRK:HET
buitenboordjes	buitenboord	ZNW:MRV:VRK:DE_
kluisboord	kluisboord	ZNW:EKV
kluisboorden	kluisboord	ZNW:MRV:DE_
kluisboordje	kluisboord	ZNW:EKV:VRK:HET
kluisboordjes	kluisboord	ZNW:MRV:VRK:DE_
schoorder	schoorder	ZNW:EKV
schoorders	schoorder	ZNW:MRV:DE_
schoordertje	schoorder	ZNW:EKV:VRK:HET
schoordertjes	schoorder	ZNW:MRV:VRK:DE_
schorsteen	schorsteen	ZNW:EKV
schorsteentoren	schorsteentoren	ZNW:EKV
schorsteenwerking	schorsteenwerking	ZNW:EKV:DE_
stootboord	stootboord	ZNW:EKV
stootboorden	stootboord	ZNW:MRV:DE_
stootboordje	stootboord	ZNW:EKV:VRK:HET
stootboordjes	stootboord	ZNW:MRV:VRK:DE_
ventilatieschorsteen	ventilatieschorsteen	ZNW:EKV
aflicht	aflicht	ZNW:EKV:HET
aflichten	aflicht	ZNW:MRV:DE_
aflichtje	aflicht	ZNW:EKV:VRK:HET
aflichtjes	aflicht	ZNW:MRV:VRK:DE_
heilicht	heilicht	BNW:STL:ONV
heilichts	heilicht	BNW:STL:IET
heilichtst	heilicht	BNW:OVR:ONV
heilichtste	heilicht	BNW:OVR:VRB
hiervoor	hiervoor	ZNW:EKV:DE_
hiervoortje	hiervoor	ZNW:EKV:VRK:HET
hiervoortjes	hiervoor	ZNW:MRV:VRK:DE_
hiervoren	hiervoor	ZNW:MRV:DE_
al	al	BNW:STL:ONV
alle	al	BNW:STL:VRB
alle	alle	ZNW:EKV
allen	al	BNW:STL:MRV:DE_
allen	alle	ZNW:MRV:DE_
als	al	BNW:STL:IET
beneden	beneden	ZNW:EKV:DE_
eenen	een	GET:MRV
eerste	eerste	ZNW:EKV
eersten	eerste	ZNW:MRV:DE_
kleine	kleine	ZNW:EKV:DE_
kleinen	kleine	ZNW:MRV:DE_
nadenken	nadenken	ZNW:EKV
nieuwe	nieuwe	ZNW:EKV
nieuwen	nieuwe	ZNW:MRV:DE_
sommig	sommig	BNW:STL:ONV
sommige	sommig	BNW:STL:VRB
sommige	sommige	ZNW:EKV
sommigen	sommig	BNW:STL:MRV:DE_
sommigen	sommige	ZNW:MRV:DE_
sommiger	sommig	BNW:VGR:ONV
sommigere	sommig	BNW:VGR:VRB
sommigeren	sommig	BNW:VGR:MRV:DE_
sommigers	sommig	BNW:VGR:IET
sommigs	sommig	BNW:STL:IET
sommigst	sommig	BNW:OVR:ONV
sommigste	sommig	BNW:OVR:VRB
